2 2 2 2 2 2 0 0 0 0 1 3 3 0 0 1
2 2 2 2 2 0 0 1 0 0 3 3 3 0 0 0
2 2 2 2 2 0 0 0 0 3 3 3 0 0 0 0
2 2 0 2 2 2 1 0 0 3 3 0 0 1 0 0
2 1 0 0 2 2 2 0 0 3 3 0 0 0 0 0
0 0 0 0 0 2 2 2 2 4 4 2 2 2 2 2
0 0 0 1 0 0 2 2 2 4 4 2 2 2 2 2
1 0 0 0 0 0 0 0 0 3 3 0 0 0 0 0
0 0 0 0 0 0 1 0 3 3 3 0 1 0 0 0
0 0 1 0 0 0 0 3 3 3 0 0 0 0 0 1
3 3 3 3 3 3 3 3 3 1 0 0 0 0 0 0
3 3 3 3 3 3 3 3 0 0 0 1 0 0 0 0